NO ./sprites/wall1.xpm
SO ./sprites/wall2.xpm
WE ./sprites/wall3.xpm
EA ./sprite/wall4.xpm

F 100,100,100
C 153,204,255

1111111   11111
10S0001   10001
1000001   10001
100000111110001
110000000000001
100000000000001
100000111000001
100000111000001
110000000000001
100000101000001
111111101111111
      101
      101
      101
      101
      101
      101
      101
 1111110111111
 1000000000001
 1000000000001
 1000000000001
 1000000000001
 1111111111111