NO ./sprites/wall1.xpm
SO ./sprites/wall2.xpm
WE ./sprites/wall3.xpm
EA ./sprites/wall4.xpm

F 100,100,100
C 153,204,255

        111111111111111111111111111
        1000000000110000000000001  
        1011000001110000000000001  
        10010000000000000000000N1  
111111111011000001110000000000001  
100000000011000001110111111111111  
11110111111111011100000010001      
11110111111111011101010010001      
11000000110101011100000010001      
10000000000000001100000010001    1 
10000000000000001101010010001   101
110000011101010111110111100011   1 
11110111 1110100 101111010001      
11111111 1111111 111111111111       
